111111
1000C1
1P0001
100E01
111111
