111111
1100C1
1P0C01
1000C1
101011
101CE1
111111
